NO img/NORTH2.xpm
SO img/SOUTH2.xpm
WE img/WEST2.xpm
EA img/EAST2.xpm

C 123,156,189
F 87,54,121

 1
101
 1

                         1111111111111111111111111111 
                        111111111111111111111111111111
                        111111111111111111111111111111
                        111111111111111111111111111111
                        111111111111111111111111111111
                        111111111111111111111111111111
                        111111111111111111111111111111
111111111111111111111111100000000000000000000000000001
100000000000000000000000000000000000000000000000000001
10000000000000000000000000000000N000000000000000000001
100000000000000000000000000100000000000000000000000001
100000000000000000000000001 10000000000000000000000001
100000000000000000000000000100000000000000000000000001
100000000000000000000000000000000000000000000000000001
100000000000000000000000000000000000000000000000000001
100000000000000001110000111000000000000000000000000001
111111111111111111 111101 1011111111111110000000000001
 11111111111111111 111111 111111111111111111111111111 
