NO img/NORTH2.xpm
SO img/SOUTH2.xpm
WE img/WEST2.xpm
EA img/EAST2.xpm

C 123,156,189
F 87,54,121

            1
           101
          10001
         1000001
        100011001
    11110000110001
   1000000N00000001
    11111111111111
