NO img/NORTH2.xpm
SO img/SOUTH2.xpm
WE img/WEST2.xpm
EA img/EAST2.xpm

C 123,156,189
F 87,54,121

1111111111111111111111111
1000000000110000000000001
1011000001110000000000001
1001000000000000000000001
1111111011111111111111111
1000000000000000000000001
1000000000000000000000001
1000000000000000000000111
1000000000001000000000001
1111111110110000011100001
1000000000110000011100001
1011000000000000000000001
1001000000000000110001001
1001000000000000110001001
1111111111111111111111111