NO img/NORTH.xpm
SO img/SOUTH.xpm
WE img/WEST.xpm
EA img/EAST.xpm

F 123,456,789
C 987,654,321

1111111111111111111111111111111111111111111
1000000110000000000000001110000000000000001
1001000000000000000001111111110000000110001
10000000000100000E0000000000000000000000001
1000000000011110000001110000000001000001111
1000000000000001000000100000000001111000001
1111111000000001100000111111111111111110001
1000001100011000000000001000000000000000111
1000000100000000000000001000000000111100111
1111111000000011111000001000000000000111001
1000000000110011000010000000111000000001111
1000001100100000000110001000000000100010001
1001111000100000011111111111000000100000001
1111111111111111111111111111111111111111111