NO img/NORTH.xpm
SO img/SOUTH.xpm
WE img/WEST.xpm
EA img/EAST.xpm

F 123,456,789
C 987,654,321

1111111111111111111111
1001110000000000000001
111111111000000W110001
1000000000000000000001
1110000000001000001111
1100000000001111000001
1111111111111111110001
1001000000000000000111
1001000000000111100111
1001000000000000111001
1111111111111111111111