NO img/NORTH.xpm
SO img/SOUTH.xpm
WE img/WEST.xpm
EA img/EAST.xpm

F 123,456,789
C 987,654,321

1111