NO img/NORTH.xpm
SO img/SOUTH.xpm
WE img/WEST.xpm
EA img/EAST.xpm

F 127,255,0
C 135,206,250

111111111
100000001
100000001
1000000011111
1000000000001
10000000011111111111111111
10000000000000000000000001
11111111111111111000000001
                1000000001
111111111111111110000000011111111111111111111
111000000000000000000000000000000000000000001
111000001111111111111111111111111111111111111
111000001
1110000011111
11100000000W1
1111111111111

1111111111111
1000000000001
1111111111111