NO img/NORTH.xpm
SO img/SOUTH.xpm
WE img/WEST.xpm
EA img/EAST.xpm

F 127,255,0
C 135,,206,250

1111111111111111111111111
1000000000110000000000001
1011000001110000000000001
1001000000000000000000001
1111111011111111111111111
1000000000000000000000001
1000000000000000000000001
10000000000000000N0000111
1000000000001000000000001
1111111110110000011100001
1000000000110000011100001
1011000000000000000000001
1001000000000000110001001
1001000000000000110001001
1111111111111111111111111

1111111111111
1000000000001
1111111111111