NO img/NORTH.xpm
WE img/WEST.xpm
SO img/SOUTH.xpm
EA img/EAST.xpm

F 127,255,0
C 135,206,250

111111111
100000001
100000001
1000000011111
1000000000001
10000000011111111111111111
10000000000000000000000001
11111111111111111001110001
                1001 10001
111111111111111110011100011111111111111111111
111000000000000000000000000000000000000000001
111000000000000000000000000011100000000000001
11100000111111111111111111111 111111111111111
111000001
1110000011111
11100000000W1
1111111111111