NO img/NORTH.xpm
SO img/SOUTH.xpm
WE img/WEST.xpm
EA img/EAST.xpm

F 855,0,0
C 987,654,321

1111111111111111111111111
1000000000110000000000001
1011000001110000000000001
1001000000000000000000001
1111111011111111111111111
1000000000000000000000001
1000000000000000000000001
1000000000000000000000111
1000111000001000000000001
11111 1110110000011100001
1000111000110000011100001
10110000000000N0000000001
1001000000000000110001001
1001000000000000110001001
1111111111111111111111111




