NO img/NORTH2.xpm
SO img/SOUTH2.xpm
WE img/WEST2.xpm
EA img/EAST2.xpm

F 194,178,128
C 42,173,230

 11111111111111111111111111111111111111
1000000000000000000000000000000000000001
1000000000000000000000000000000000000001
1000000000000000000000000000000000000001
1000000000000000000000000000000000000001
1000000000000000001010000000000000000001
100000000000000000101000000000000000000
1000000000000000001N10010000000000000001
1000000000000000001110010000000000000001
1000000000000000000000000000000000000001
1000000000000000000000000000000000000001
1000000000000000000000000000000000000001
1000000000000000000000000000000000000001
1000000000000000000000000000000000000001
 11111111111111111111111111111111111111