NO img/NORTH.xpm
SO img/SOUTH.xpm
WE img/WEST.xpm
EA img/EAST.xpm
F 116,212,52
C 135,206,235

 1111111111111111111111
100000000000000000000001
 1000000000000000000001
111111111111111111111111
0000000000000S0000000000